111111111111
1P10001C0001
100C00010111
1000000000E1
111111111111
