11111111111111111111111111111111111111111111111111111111111111111111111111
11111111000000000000000000000000000000000000000000000000000000000000000001
10000000000000000000000000000000000000000000000000000000000000P00000000001
10000000000011111110000000000111111111100000000000000000000000000000000001
10000000000000000000000000000000000000000000000000000000000000000000000001
1000000C000000000000000000000000000000000000000000000C00000000000000000001
10000000000000000000000000000000000000000000000000000000000000000000000001
100000000000000000000000000000C0000000000000000000000000000000000000000001
10000000000000000000000000000000000000000000000000000000000000000000000001
10000000000000000001111111111110000000000000000000000000000000000000000001
10000000000000000000000000000000000000000000000000000000000000000000000001
1000000CC000000000000000000000000000000000000000000000000000000000E0000001
10000000000000000000000000000000000000000000000000000000000000000000000001
11111111111111111111111111111111111111111111111111111111111111111111111111
