1111111111111111
1P00000100000001
1000000100C00001
1000000100C00001
100C000100000E01
1111111111111111
