1111111111111111111111111
1P000000000000000C0000001
1C00000000000000000000001
1000000000000E00000000001
100000000C000000000000001
1C0000000P0000000000C0001
1111111111111111111111111
