1111111111
1P0C000001
100C100001
100C1000E1
100C100000
1111111111
